12X15
Level7
###############
# @        A o#
#   ###########
#     @       #
##@         @ #
#          #  #
#    # #   #  #
#    #o#   #  #
#    #o#   #  #
#    #o#   @  #
#    #o#      #
###############