10X10
Level5
##########
#o   o #o#
#o     #o#
#@   @ @o#
#    @ @o#
#@      @#
#        #
#### ### #
#A     @o#
##########