15X15
Level9
###############
#o# @    o    #
#o#     #@#   #
#o#     # #   #
#o#           #
#o#           #
#o#@@@        #
#             #
#   @@        #
#            o#
#            ##
#            o#
#@@          @#
#o    o     @A#
###############