6X6
Level2
######
# A  #
# @  #
# o@o#
#    #
######