5X10
##########
# A    @o#
# @      #
# o    @o#
##########